0001000001001110000111003
0001000001001110000001100
1101000001000000000000100
0000000000000001111000100
0000000100000010000011100
0000000100000100011010100
1011111111111000100010000
0000000001000001000000000
0011111001001110001001111
0000001001000010000100010
0111001001001110010010000
1101101000000010100001000
0000000001000011000000100
1101111011111110000000000
0000100001010010111111111
0010100001010110000000000
0010000001000011111111100
0111110000000010000000000
0000010011100000011111111
1111010010100111000000000
0001011110110111111111110
0001000000100111000000000
0000001000100000001111111
0000001000100000001000000
2000001000000000001000000
