1111111111111111111111111
1000000010000000010000011
1011111011111111000010001
1010000010000000011111111
1010111010111110011000011
1011100010000010010011003
1000001011011011011001101
1111111010010001111100101
1000100000010100000110101
1010001111110111100000101
1011111000000000111110111
1000001011111110000010101
1010100010000011111010101
1110111110111000001010101
1000000000101111101010101
1010111111100000101010101
1010000001000100101110101
1010010001011110101000101
1011011101010010101011101
1001000101010110100010001
1101111101010000111110001
2000000001011000011100101
1101101101111100010001101
1000100100000000000000101
1111111111111111111111111
